5 5

5 4 3 6 1

4 0
1 4

5 6 1 2 4
2 3 3 6 4
4 6 2 1 2
5 4 4 5 1
4 6 1 3 5