6 5

6 4 3 2 5

0 0
5 4

4 6 2 5 1
5 2 1 0 4
6 2 3 1 5
6 4 6 3 6
5 3 4 5 1
3 6 0 3 3