6 5

3 2 5 1 6

2 4
0 3

5 4 6 2 1
3 1 0 4 5
6 2 6 6 3
4 5 1 2 3
2 3 1 6 5
1 5 6 2 4