7 7

5 4 3 6 1

3 0
3 6

0 3 6 4 1 3 0
4 3 2 4 0 2 4
5 0 1 2 5 3 5
3 5 3 1 3 6 0
5 1 0 5 4 2 1
0 2 4 6 2 6 3
2 4 0 3 1 4 2