4 5

6 3 4 5 2

3 0
2 0

3 5 2 4 1
6 1 3 2 3
3 2 5 1 6
4 6 5 1 2