4 5

3 6 1 2 5

0 4
3 0

3 4 5 3 4
4 6 1 5 2
5 2 4 1 4
6 1 6 5 3