6 6

4 5 2 1 6

2 0
5 3

5 3 1 4 6 3
4 5 0 2 3 1
2 6 4 3 1 5
1 4 5 3 0 6
4 5 4 6 5 1
6 3 2 4 1 4

